###########
#    A    #
#         #
#    ###  #
#    #    #
#  ########
#    # #  #
#   #  #  #
#     #S  #
#         #
###########