#######
#    A#
# #####
#   #S#
# # # #
# ### #
#     #
#######